Test Map 1
25
25
5
2
XXXXXXXXXXXXXXXX0XXXXXXXX
X00000000000000000XXXX00X
X00000000000000000000000X
X00000000000000000XXXXX0X
X00000000000000000000000X
X0XXX000000X000000000000X
X0XXX0000000000000X00000X
X0XXX0000000000000X00000X
X0000000000X000000X00000X
X0000000000X000000X00000X
X0000000000X000000X00000X
X000000XXXXXXXXX00X00000X
X00000000000000X00XXXXXXX
X00000000X00000X00X00000X
X0000XXXXXXXXXXX00000000X
X0000X000X00000000X00000X
X0000X000000000000X00000X
X0000XXXXX00000000000000X
X00000000000000000X00000X
X00000000000000000000000X
X00000000000000000X00000X
X00000000000000000X00000X
X00000000000000000000000X
X00000000000000000X00000X
XXXXXXXXXXXXXXXXXXXXXXXXX